Aj Punnagai - AJP (Varam)
Accessory Villa - ACC(Gayatri)
Ananya - ANA(Divya)
Arjunaaz - ARJ(Gayatri)
Aarya - AAR (Gayatri)
Varsha - VAR(Varam)
Chendur Collections - CHE(Varam)
Raji Fancy - RAJ(Varam)
Quills and Spills - QUI(Divya)
Pradya - PRA(Divya)
Sai Nakshatra - SAI(Gayatri)
Vibha - VIB
Shree Designs - SHR
Arshi - ARS(Varam)
Anicha - ANI(Gayatri)
Rimili - RIM
Kattam - KAT
Shallin - SHA(Divya)
Trinetrum - TRI
Studio Blue Fashions - STU
Sowparnika - SOW
Hamsa - HAM
Abhinaya
Dheekshu
Smars Jewellery
Siddi Collections
The SG Crafts
Adharvas
Glitter and Shine
Meenakshi - MEE(In Active)
Antique Attraction - ANT(In Active)



Gold Back Chain	60
Matte Finish Back Chain 	80

